{
  "meta": {
    "tileSize": 16,
    "width": 28,
    "height": 31
  },
  "tiles": {
    "legend": {
      "#": "WALL",
      ".": "PELLET",
      "o": "POWER",
      "T": "TUNNEL"
    },
    "rows": [
      "############################",
      "#o...........##...........o#",
      "#.####.#####.##.#####.####.#",
      "#.####.#####.##.#####.####.#",
      "#..........................#",
      "#.####.##.########.##.####.#",
      "#......##....##....##......#",
      "######.#####.##.#####.######",
      "######.#####.##.#####.######",
      "#............##............#",
      "#.####.#####.##.#####.####.#",
      "#...##................##...#",
      "###.##.##.########.##.##.###",
      "#......##....##....##......#",
      "#.##########.##.##########.#",
      "#..........................#",
      "#.##########.##.##########.#",
      "#......##....##....##......#",
      "###.##.##.########.##.##.###",
      "#...##................##...#",
      "#.####.#####.##.#####.####.#",
      "#............##............#",
      "######.#####.##.#####.######",
      "######.#####.##.#####.######",
      "#......##....##....##......#",
      "#.####.##.########.##.####.#",
      "#..........................#",
      "#.####.#####.##.#####.####.#",
      "#.####.#####.##.#####.####.#",
      "#o...........TT...........o#",
      "############################"
    ]
  },
  "spawns": {
    "pacman": { "x": 2, "y": 1, "dir": "RIGHT" },
    "ghosts": {
      "blinky": { "x": 13, "y": 15, "dir": "LEFT" },
      "pinky": { "x": 14, "y": 15, "dir": "RIGHT" },
      "inky": { "x": 12, "y": 16, "dir": "LEFT" },
      "clyde": { "x": 15, "y": 16, "dir": "RIGHT" }
    }
  },
  "tunnels": [
    { "from": { "x": 13, "y": 29 }, "to": { "x": 14, "y": 29 } },
    { "from": { "x": 14, "y": 29 }, "to": { "x": 13, "y": 29 } }
  ]
}

